S.....#.E
#########
.........
.........
.........
.........
.........
