S....#..E
.##..#.#.
..#..#.#.
..#......
#########
..#......
..#.###..
