#S......#.#.....#..#
#.###.###.#.###.#.##
#...#.#.....#.#...#.
#.#.#.###.###.###.#.
#.#.....#.....#...#.
###.###.#.#####.###.
#.#.#...#.#.#.....#.
#.#.#.#####.#.###.#.
#.#.#.....#.#.#...#.
#.#####.#.#.###.#.#.
#.....#.#.#.....#.##
#####.#.#.#######.#.
#.....#.#.#.........
#.#.###.#.#.#######.
#.#.....#.........#.
#.#######.#######.#.
#.........#.....#.#.
#########...###....E
