...#S.#.....
#...#.#.#.#.
#...#.#.#.#.
....#.#.....
#####.#####.
#.#...#.####
..#.#.#..##E
..#...#.###.
..#...#.#...
.##.........
