S....#..#...
##.#.#.#...#
##.##.#.#...
##...#######
##.#......##
...######.##
.#####.##.##
.#.#....#.##
.#.#.#.##.##
.########E##
..........##
